7
6
1 4 2 3 0 1
1 3 2 4 1 1
1 2 2 3 2 2
2 1 3 3 2 1
4 2 3 2 1 1
2 1 1 1 1 1
4 2 2 1 1 3

