7
6
4 3 4 4 3 2
3 2 3 3 2 1
2 1 2 2 1 0
1 2 2 1 1 1
2 3 3 2 2 1
3 2 2 1 1 2
4 3 2 2 1 2

