7
6
1 2 1 1 2 2
1 3 1 2 3 3
2 4 1 3 2 2
3 2 2 1 1 2
4 2 3 1 2 2
3 1 3 2 1 2
4 0 4 3 2 1

