7
6
4 3 3 4 2 4
2 2 2 3 4 3
2 1 2 1 1 2
2 1 1 1 1 2
3 1 1 0 1 1
3 2 1 1 1 1
2 1 2 1 2 1
