7
6
4 2 4 2 3 3
2 1 2 1 1 2
2 1 1 3 0 2
1 1 3 1 1 1
4 3 2 2 1 2
1 2 4 1 1 2
1 3 1 2 1 1
