7
6
1 1 1 1 2 1
2 1 1 2 2 1
2 1 2 0 2 1
1 2 2 1 1 1
4 3 3 1 1 4
2 3 2 2 1 2
2 4 2 2 1 4
