7
6
1 2 1 2 2 2
3 4 4 1 1 1
1 2 1 2 3 3
2 1 2 1 0 1
2 2 1 2 2 3
2 4 2 1 1 3
1 4 3 3 2 2
